{
  "cf]": "ओ",
  "cf}": "औ",
  "cf": "आ",
  "f]": "ो",
  "f}": "ौ",
  "if]": "षो",
  "if}": "षौ",

  "Qm": "फ्र",
  "k|": "प्त",
  "km": "फ",

  "c": "अ",
  "q": "आ",
  "O": "इ",
  "i": "ई",
  "p": "उ",
  "P": "ऊ",
  "C": "ए",
  "[": "ऐ",

  "s": "क",
  "v": "ख",
  "u": "ग",
  "3": "घ",
  "ª": "ङ",

  "r": "च",
  "5": "छ",
  "h": "ज",
  "´": "झ",
  "~": "ञ",

  "6": "ट",
  "7": "ठ",
  "8": "ड",
  "9": "ढ",
  "0": "ण",

  "t": "त",
  "y": "थ",
  "b": "द",
  "w": "ध",
  "g": "न",

  "k": "प",
  "a": "ब",
  "e": "भ",
  "d": "म",

  "o": "य",
  "/": "र",
  "n": "ल",
  "j": "व",

  "z": "श",
  "if": "ष",
  ";": "स",
  "x": "ह",

  "f": "ा",
  "l": "ि",
  "L": "ी",
  "'": "ु",
  "\"": "ू",
  "]": "े",
  "}": "ै",
  "M": "ं",
  "F": "ँ",
  "H": "ः",
  "\\": "्",

  "?": "श्र",
  "_": "रु",
  "+": "ृ",
  "=": "ॄ",

  "!": "१",
  "@": "२",
  "#": "३",
  "$": "४",
  "%": "५",
  "^": "६",
  "&": "७",
  "*": "८",
  "(": "९",
  ")": "०",

  ".": "।",
  "<": ",",
  ">": ".",
  "|": "॥",
  ":": "ँ",

  "Ì": "त्र",
  "Í": "क्ष",
  "Î": "ज्ञ",
  "ß": "श्र",
  "å": "द्य",
  "Ø": "च्य",

  "¿": "रू",
  "Å": "हृ",
  "Ë": "झ्",
  "ç": "ॐ",
  "æ": "“",
  "Þ": "।",

  "‚": "घ",
  "ˆ": "फ",
  "‰": "भ",
  "‹": "झ",
  "•": "ड",
  "˜": "ु",
  "›": "ढ",
  "£": "छ",
  "¥": "े",
  "§": "ठ",
  "°": "ञ",
  "±": "+",
  "¶": "ण",
  "Ð": "…",
  "Ö": "=",
  "Ù": ";",
  "Ú": "'",
  "Û": "!",
  "Ü": "%",
  "Ý": "ठू",
  "÷": "/",

  " ": " ",
  "\n": "\n",
  "\t": "\t"
}
